####################
#                  #
#  *   #           #
#      #           #
#  #####           #
#      #           #
#      #####       #
#          #       #
#          #       #
#          #       #
#          #####   #
#                  #
#  ^           ^   #
#                  #
#      ^           #
#                  #
#           ^      #
#                  #
#                  #
####################
