####################
#                  #
#  *   #           #
#      #   ^       #
#  #####           #
#      #       ^   #
#      #####       #
#          #       #
#          #       #
#     ^    #       #
#          #####   #
#                  #
#  ^           ^   #
#                  #
#      ^           #
#                  #
#           ^      #
#                  #
#                  #
####################
